database = `AanI	TTA'TAA
AarI	CACCTGCnnnn'nnnn_
AasI	GACnn_nn'nnGTC
AatII	G_ACGT'C
AbaSI	Cnnnnnnnnn_nn'
AbsI	CC'TCGA_GG
AccI	GT'mk_AC
AccII	CG'CG
AccIII	T'CCGG_A
Acc16I	TGC'GCA
Acc36I	ACCTGCnnnn'nnnn_
Acc65I	G'GTAC_C
AccB1I	G'GyrC_C
AccB7I	CCAn_nnn'nTGG
AccBSI	CCG'CTC
AceIII	CAGCTCnnnnnnn'nnnn_
AciI	C'CG_C
AclI	AA'CG_TT
AclWI	GGATCnnnn'n_
AcoI	y'GGCC_r
AcsI	r'AATT_y
AcuI	CTGAAGnnnnnnnnnnnnnn_nn'
AcvI	CAC'GTG
AcyI	Gr'CG_yC
AdeI	CAC_nnn'GTG
AfaI	GT'AC
AfeI	AGC'GCT
AfiI	CCnn_nnn'nnGG
AflII	C'TTAA_G
AflIII	A'CryG_T
AgeI	A'CCGG_T
AgsI	TT_s'AA
AhaIII	TTT'AAA
AhdI	GACnn_n'nnGTC
AhlI	A'CTAG_T
AjiI	CAC'GTC
AjnI	'CCwGG_
AjuI	GAAnnnnnnnTTGGnnnnnn_nnnnn'
AjuI	CCAAnnnnnnnTTCnnnnnnn_nnnnn'
AleI	CACnn'nnGTG
AlfI	GCAnnnnnnTGCnnnnnnnnnn_nn'
AloI	GAACnnnnnnTCCnnnnnnn_nnnnn'
AloI	GGAnnnnnnGTTCnnnnnnn_nnnnn'
AluI	AG'CT
AluBI	AG'CT
AlwI	GGATCnnnn'n_
Alw21I	G_wGCw'C
Alw26I	GTCTCn'nnnn_
Alw44I	G'TGCA_C
AlwNI	CAG_nnn'CTG
Ama87I	C'yCGr_G
AmaCSI	GCTCCAnnnnnnnnn_nn'
Aor13HI	T'CCGG_A
Aor51HI	AGC'GCT
AoxI	'GGCC_
ApaI	G_GGCC'C
ApaBI	GCA_nnnnn'TGC
ApaLI	G'TGCA_C
ApeKI	G'CwG_C
ApoI	r'AATT_y
ApyPI	ATCGACnnnnnnnnnnnnnnnnnn_nn'
AquII	GCCGnACnnnnnnnnnnnnnnnnnn_nn'
AquIII	GAGGAGnnnnnnnnnnnnnnnnnn_nn'
AquIV	GrGGAAGnnnnnnnnnnnnnnnnn_nn'
ArsI	GACnnnnnnTTyGnnnnnn_nnnnn'
ArsI	CrAAnnnnnnGTCnnnnnnnn_nnnnn'
AscI	GG'CGCG_CC
AseI	AT'TA_AT
Asi256I	G'AT_C
AsiGI	A'CCGG_T
AsiSI	GCG_AT'CGC
Asp700I	GAAnn'nnTTC
Asp718I	G'GTAC_C
AspA2I	C'CTAG_G
AspBHI	ysCnsnnnnnnnn'nnnn_
AspLEI	G_CG'C
AspS9I	G'GnC_C
AsuI	G'GnC_C
AsuII	TT'CG_AA
AsuC2I	CC's_GG
AsuHPI	GGTGAnnnnnnn_n'
AsuNHI	G'CTAG_C
AvaI	C'yCGr_G
AvaII	G'GwC_C
AvrII	C'CTAG_G
AxyI	CC'TnA_GG
BaeI	ACnnnnGTAyCnnnnnnn_nnnnn'
BaeI	GrTACnnnnGTnnnnnnnnnn_nnnnn'
BaeGI	G_kGCm'C
BalI	TGG'CCA
BamHI	G'GATC_C
BanI	G'GyrC_C
BanII	G_rGCy'C
BarI	GAAGnnnnnnTACnnnnnnn_nnnnn'
BarI	GTAnnnnnnCTTCnnnnnnn_nnnnn'
BauI	C'ACGA_G
BbrPI	CAC'GTG
BbsI	GAAGACnn'nnnn_
BbvI	GCAGCnnnnnnnn'nnnn_
BbvII	GAAGACnn'nnnn_
Bbv12I	G_wGCw'C
BbvCI	CC'TCA_GC
BccI	CCATCnnnn'n_
Bce83I	CTTGAGnnnnnnnnnnnnnn_nn'
BceAI	ACGGCnnnnnnnnnnnn'nn_
BceSIV	GCAGCnnnnnnnnn'nn_
BceSIV	GCTGCnnnnn'nn_
BcefI	ACGGCnnnnnnnnnnnn'n_
BcgI	CGAnnnnnnTGCnnnnnnnnnn_nn'
BcgI	GCAnnnnnnTCGnnnnnnnnnn_nn'
BciT130I	CC'w_GG
BciVI	GTATCCnnnnn_n'
BclI	T'GATC_A
BcnI	CC's_GG
BcoDI	GTCTCn'nnnn_
BcuI	A'CTAG_T
BdaI	TGAnnnnnnTCAnnnnnnnnnn_nn'
BetI	w'CCGG_w
BfaI	C'TA_G
BfiI	ACTGGGnnnn_n'
BfmI	C'TryA_G
BfoI	r_GCGC'y
BfrI	C'TTAA_G
BfuI	GTATCCnnnnn_n'
BfuAI	ACCTGCnnnn'nnnn_
BglI	GCCn_nnn'nGGC
BglII	A'GATC_T
BinI	GGATCnnnn'n_
BisI	GC'n_GC
BlnI	C'CTAG_G
BlpI	GC'TnA_GC
BlsI	GC_n'GC
BmcAI	AGT'ACT
Bme18I	G'GwC_C
Bme1390I	CC'n_GG
BmeDI	C_nn'
BmeRI	GACnn_n'nnGTC
BmeT110I	C'yCGr_G
BmgBI	CAC'GTC
BmgT120I	G'GnC_C
BmiI	GGn'nCC
BmrI	ACTGGGnnnn_n'
BmrFI	CC'n_GG
BmsI	GCATCnnnnn'nnnn_
BmtI	G_CTAG'C
BmuI	ACTGGGnnnn_n'
BoxI	GACnn'nnGTC
BpiI	GAAGACnn'nnnn_
BplI	GAGnnnnnCTCnnnnnnnn_nnnnn'
BpmI	CTGGAGnnnnnnnnnnnnnn_nn'
Bpu10I	CC'TnA_GC
Bpu14I	TT'CG_AA
Bpu1102I	GC'TnA_GC
BpuEI	CTTGAGnnnnnnnnnnnnnn_nn'
BpuMI	CC's_GG
BsaI	GGTCTCn'nnnn_
Bsa29I	AT'CG_AT
BsaAI	yAC'GTr
BsaBI	GATnn'nnATC
BsaHI	Gr'CG_yC
BsaJI	C'CnnG_G
BsaWI	w'CCGG_w
BsaXI	ACnnnnnCTCCnnnnnnn_nnn'
BsaXI	GGAGnnnnnGTnnnnnnnnn_nnn'
BsbI	CAACACnnnnnnnnnnnnnnnnnnn_nn'
Bsc4I	CCnn_nnn'nnGG
BscAI	GCATCnnnn'nn_
Bse1I	ACTG_Gn'
Bse8I	GATnn'nnATC
Bse21I	CC'TnA_GG
Bse118I	r'CCGG_y
BseAI	T'CCGG_A
BseBI	CC'w_GG
BseCI	AT'CG_AT
BseDI	C'CnnG_G
Bse3DI	GCAATG_nn'
BseGI	GGATG_nn'
BseJI	GATnn'nnATC
BseLI	CCnn_nnn'nnGG
BseMI	GCAATG_nn'
BseMII	CTCAGnnnnnnnn_nn'
BseNI	ACTG_Gn'
BsePI	G'CGCG_C
BseRI	GAGGAGnnnnnnnn_nn'
BseSI	G_kGCm'C
BseXI	GCAGCnnnnnnnn'nnnn_
BseX3I	C'GGCC_G
BseYI	C'CCAG_C
BsgI	GTGCAGnnnnnnnnnnnnnn_nn'
Bsh1236I	CG'CG
Bsh1285I	CG_ry'CG
BshFI	GG'CC
BshNI	G'GyrC_C
BshTI	A'CCGG_T
BshVI	AT'CG_AT
BsiI	C'ACGA_G
BsiEI	CG_ry'CG
BsiHKAI	G_wGCw'C
BsiHKCI	C'yCGr_G
BsiSI	C'CG_G
BsiWI	C'GTAC_G
BsiYI	CCnn_nnn'nnGG
BslI	CCnn_nnn'nnGG
BslFI	GGGACnnnnnnnnnn'nnnn_
BsmI	GAATG_Cn'
BsmAI	GTCTCn'nnnn_
BsmBI	CGTCTCn'nnnn_
BsmFI	GGGACnnnnnnnnnn'nnnn_
BsnI	GG'CC
Bso31I	GGTCTCn'nnnn_
BsoBI	C'yCGr_G
Bsp13I	T'CCGG_A
Bsp19I	C'CATG_G
Bsp24I	GACnnnnnnTGGnnnnnnn_nnnnn'
Bsp24I	CCAnnnnnnGTCnnnnnnnn_nnnnn'
Bsp68I	TCG'CGA
Bsp119I	TT'CG_AA
Bsp120I	G'GGCC_C
Bsp143I	'GATC_
Bsp1286I	G_dGCh'C
Bsp1407I	T'GTAC_A
Bsp1720I	GC'TnA_GC
BspACI	C'CG_C
BspANI	GG'CC
BspCNI	CTCAGnnnnnnn_nn'
BspDI	AT'CG_AT
BspD6I	GAGTCnnnn'nn_
BspEI	T'CCGG_A
BspFNI	CG'CG
BspHI	T'CATG_A
BspLI	GGn'nCC
BspLU11I	A'CATG_T
BspMI	ACCTGCnnnn'nnnn_
BspMII	T'CCGG_A
BspMAI	C_TGCA'G
BspOI	G_CTAG'C
BspPI	GGATCnnnn'n_
BspQI	GCTCTTCn'nnn_
BspTI	C'TTAA_G
BspT104I	TT'CG_AA
BspT107I	G'GyrC_C
BspTNI	GGTCTCn'nnnn_
BsrI	ACTG_Gn'
BsrBI	CCG'CTC
BsrDI	GCAATG_nn'
BsrFI	r'CCGG_y
BsrGI	T'GTAC_A
BssAI	r'CCGG_y
BssECI	C'CnnG_G
BssHII	G'CGCG_C
BssMI	'GATC_
BssNI	Gr'CG_yC
BssNAI	GTA'TAC
BssSI	C'ACGA_G
BssT1I	C'CwwG_G
Bst6I	CTCTTCn'nnn_
Bst1107I	GTA'TAC
BstACI	Gr'CG_yC
BstAFI	C'TTAA_G
BstAPI	GCAn_nnn'nTGC
BstAUI	T'GTAC_A
BstBI	TT'CG_AA
Bst2BI	C'ACGA_G
BstBAI	yAC'GTr
Bst4CI	AC_n'GT
BstC8I	GCn'nGC
BstDEI	C'TnA_G
BstDSI	C'CryG_G
BstEII	G'GTnAC_C
BstENI	CCTnn'n_nnAGG
BstF5I	GGATG_nn'
BstFNI	CG'CG
BstH2I	r_GCGC'y
BstHHI	G_CG'C
BstKTI	G_AT'C
BstMAI	GTCTCn'nnnn_
BstMBI	'GATC_
BstMCI	CG_ry'CG
BstMWI	GCnn_nnn'nnGC
BstNI	CC'w_GG
BstNSI	r_CATG'y
BstPI	G'GTnAC_C
BstPAI	GACnn'nnGTC
BstSCI	'CCnGG_
BstSFI	C'TryA_G
BstSLI	G_kGCm'C
BstSNI	TAC'GTA
BstUI	CG'CG
Bst2UI	CC'w_GG
BstV1I	GCAGCnnnnnnnn'nnnn_
BstV2I	GAAGACnn'nnnn_
BstXI	CCAn_nnnn'nTGG
BstX2I	r'GATC_y
BstYI	r'GATC_y
BstZI	C'GGCC_G
BstZ17I	GTA'TAC
BsuI	GTATCCnnnnn_n'
Bsu15I	AT'CG_AT
Bsu36I	CC'TnA_GG
BsuRI	GG'CC
BsuTUI	AT'CG_AT
BtgI	C'CryG_G
BtgZI	GCGATGnnnnnnnnnn'nnnn_
BthCI	G_CnG'C
BtrI	CAC'GTC
BtsI	GCAGTG_nn'
BtsIMutI	CAGTG_nn'
BtsCI	GGATG_nn'
BtuMI	TCG'CGA
BveI	ACCTGCnnnn'nnnn_
Cac8I	GCn'nGC
CaiI	CAG_nnn'CTG
CauII	CC's_GG
CchII	GGArGAnnnnnnnnn_nn'
CchIII	CCCAAGnnnnnnnnnnnnnnnnnn_nn'
CciI	T'CATG_A
CciNI	GC'GGCC_GC
CdiI	CATC'G
CdpI	GCGGAGnnnnnnnnnnnnnnnnnn_nn'
CfoI	G_CG'C
CfrI	y'GGCC_r
Cfr9I	C'CCGG_G
Cfr10I	r'CCGG_y
Cfr13I	G'GnC_C
Cfr42I	CC_GC'GG
ChaI	_GATC'
CjeI	CCAnnnnnnGTnnnnnnnnn_nnnnnn'
CjeI	ACnnnnnnTGGnnnnnnnn_nnnnnn'
CjeNIII	GkAAyGnnnnnnnnnnnnnnnnn_nn'
CjePI	CCAnnnnnnnTCnnnnnnnn_nnnnnn'
CjePI	GAnnnnnnnTGGnnnnnnn_nnnnnn'
ClaI	AT'CG_AT
CpoI	CG'GwC_CG
CseI	GACGCnnnnn'nnnnn_
CsiI	A'CCwGG_T
CspI	CG'GwC_CG
Csp6I	G'TA_C
CspAI	A'CCGG_T
CspCI	CAAnnnnnGTGGnnnnnnnnnn_nn'
CspCI	CCACnnnnnTTGnnnnnnnnnnn_nn'
CstMI	AAGGAGnnnnnnnnnnnnnnnnnn_nn'
CviAII	C'AT_G
CviJI	rG'Cy
CviKI-1	rG'Cy
CviQI	G'TA_C
CviRI	TG'CA
DdeI	C'TnA_G
DinI	GGC'GCC
DpnI	GA'TC
DpnII	'GATC_
DraI	TTT'AAA
DraII	rG'GnC_Cy
DraIII	CAC_nnn'GTG
DraRI	CAAGnACnnnnnnnnnnnnnnnnnn_nn'
DrdI	GACnn_nn'nnGTC
DrdIV	TACGACnnnnnnnnnnnnnnnnnn_nn'
DrdV	CATGnACnnnnnnnn_nn'
DriI	GACnn_n'nnGTC
DsaI	C'CryG_G
DseDI	GACnn_nn'nnGTC
EaeI	y'GGCC_r
EagI	C'GGCC_G
Eam1104I	CTCTTCn'nnn_
Eam1105I	GACnn_n'nnGTC
EarI	CTCTTCn'nnn_
EciI	GGCGGAnnnnnnnnn_nn'
Ecl136II	GAG'CTC
EclXI	C'GGCC_G
Eco24I	G_rGCy'C
Eco31I	GGTCTCn'nnnn_
Eco32I	GAT'ATC
Eco47I	G'GwC_C
Eco47III	AGC'GCT
Eco52I	C'GGCC_G
Eco57I	CTGAAGnnnnnnnnnnnnnn_nn'
Eco72I	CAC'GTG
Eco81I	CC'TnA_GG
Eco88I	C'yCGr_G
Eco91I	G'GTnAC_C
Eco105I	TAC'GTA
Eco130I	C'CwwG_G
Eco147I	AGG'CCT
EcoBLMcrX	rC's_rC
EcoHI	'CCsGG_
EcoICRI	GAG'CTC
Eco57MI	CTGrAGnnnnnnnnnnnnnn_nn'
EcoNI	CCTnn'n_nnAGG
EcoO65I	G'GTnAC_C
EcoO109I	rG'GnC_Cy
EcoRI	G'AATT_C
EcoRII	'CCwGG_
EcoRV	GAT'ATC
EcoT14I	C'CwwG_G
EcoT22I	A_TGCA'T
EcoT38I	G_rGCy'C
Eco53kI	GAG'CTC
EgeI	GGC'GCC
EheI	GGC'GCC
ErhI	C'CwwG_G
EsaBC3I	TC'GA
EspI	GC'TnA_GC
Esp3I	CGTCTCn'nnnn_
FaeI	_CATG'
FaiI	yA'Tr
FalI	AAGnnnnnCTTnnnnnnnn_nnnnn'
FaqI	GGGACnnnnnnnnnn'nnnn_
FatI	'CATG_
FauI	CCCGCnnnn'nn_
FauNDI	CA'TA_TG
FbaI	T'GATC_A
FblI	GT'mk_AC
FmuI	G_GnC'C
FnuDII	CG'CG
Fnu4HI	GC'n_GC
FokI	GGATGnnnnnnnnn'nnnn_
FriOI	G_rGCy'C
FseI	GG_CCGG'CC
FspI	TGC'GCA
FspAI	rTGC'GCAy
FspBI	C'TA_G
FspEI	CCnnnnnnnnnnnn'nnnn_
Fsp4HI	GC'n_GC
GdiII	C'GGCC_r
GlaI	GC'GC
GluI	GC'n_GC
GsaI	C_CCAG'C
GsuI	CTGGAGnnnnnnnnnnnnnn_nn'
HaeI	wGG'CCw
HaeII	r_GCGC'y
HaeIII	GG'CC
HaeIV	GAynnnnnrTCnnnnnnnnn_nnnnn'
HaeIV	GAynnnnnrTCnnnnnnn_nnnnnn'
HapII	C'CG_G
HauII	TGGCCAnnnnnnnnn_nn'
HgaI	GACGCnnnnn'nnnnn_
HgiAI	G_wGCw'C
HgiCI	G'GyrC_C
HgiJII	G_rGCy'C
HhaI	G_CG'C
Hin1I	Gr'CG_yC
Hin1II	_CATG'
Hin4I	GAynnnnnvTCnnnnnnnn_nnnnn'
Hin4I	GAbnnnnnrTCnnnnnnnn_nnnnn'
Hin4II	CCTTCnnnnn_n'
Hin6I	G'CG_C
HinP1I	G'CG_C
HincII	GTy'rAC
HindII	GTy'rAC
HindIII	A'AGCT_T
HinfI	G'AnT_C
HpaI	GTT'AAC
HpaII	C'CG_G
HphI	GGTGAnnnnnnn_n'
Hpy8I	GTn'nAC
Hpy99I	_CGwCG'
Hpy166II	GTn'nAC
Hpy178III	TC'nn_GA
Hpy188I	TC_n'GA
Hpy188III	TC'nn_GA
HpyAV	CCTTCnnnnn_n'
HpyCH4III	AC_n'GT
HpyCH4IV	A'CG_T
HpyCH4V	TG'CA
HpyF3I	C'TnA_G
HpyF10VI	GCnn_nnn'nnGC
HpySE526I	A'CG_T
HsoII	CAynnnnnrTGnnnnnnnn_nnnnnn'
Hsp92I	Gr'CG_yC
Hsp92II	_CATG'
HspAI	G'CG_C
KasI	G'GCGC_C
KflI	GG'GwC_CC
KpnI	G_GTAC'C
Kpn2I	T'CCGG_A
KroI	G'CCGG_C
KspI	CC_GC'GG
Ksp22I	T'GATC_A
Ksp632I	CTCTTCn'nnn_
KspAI	GTT'AAC
Kzo9I	'GATC_
LguI	GCTCTTCn'nnn_
LmnI	GCTC_Cn'
LpnI	rGC'GCy
LpnPI	CCdGnnnnnnnnnn'nnnn_
Lsp1109I	GCAGCnnnnnnnn'nnnn_
LweI	GCATCnnnnn'nnnn_
MabI	A'CCwGG_T
MaeI	C'TA_G
MaeII	A'CG_T
MaeIII	'GTnAC_
MalI	GA'TC
MaqI	CrTTGACnnnnnnnnnnnnnnnnnnn_nn'
MauBI	CG'CGCG_CG
MbiI	CCG'CTC
MboI	'GATC_
MboII	GAAGAnnnnnnn_n'
McaTI	GC_GC'GC
McrI	CG_ry'CG
MfeI	C'AATT_G
MflI	r'GATC_y
MhlI	G_dGCh'C
MlsI	TGG'CCA
MluI	A'CGCG_T
MluCI	'AATT_
MluNI	TGG'CCA
MlyI	GAGTCnnnnn'
Mly113I	GG'CG_CC
MmeI	TCCrACnnnnnnnnnnnnnnnnnn_nn'
MnlI	CCTCnnnnnn_n'
Mox20I	TGG'CCA
Mph1103I	A_TGCA'T
MreI	CG'CCGG_CG
MroI	T'CCGG_A
MroNI	G'CCGG_C
MroXI	GAAnn'nnTTC
MscI	TGG'CCA
MseI	T'TA_A
MslI	CAynn'nnrTG
MspI	C'CG_G
Msp20I	TGG'CCA
MspA1I	CmG'CkG
MspCI	C'TTAA_G
MspGI	G_CCGG'C
MspJI	Cnnrnnnnnnnnn'nnnn_
MspR9I	CC'n_GG
MssI	GTTT'AAAC
MstI	TGC'GCA
MteI	GCGC'n_GCGC
MunI	C'AATT_G
MvaI	CC'w_GG
Mva1269I	GAATG_Cn'
MvnI	CG'CG
MwoI	GCnn_nnn'nnGC
NaeI	GCC'GGC
NarI	GG'CG_CC
NciI	CC's_GG
NcoI	C'CATG_G
NdeI	CA'TA_TG
NdeII	'GATC_
NgoAVII	GCCGCnnnnnnn'
NgoAVIII	GACnnnnnTGAnnnnnnnnnnn_nn'
NgoAVIII	TCAnnnnnGTCnnnnnnnnnnnn_nn'
NgoMIV	G'CCGG_C
NheI	G'CTAG_C
NlaIII	_CATG'
NlaIV	GGn'nCC
NlaCI	CATCACnnnnnnnnnnnnnnnnn_nn'
Nli3877I	C_yCGr'G
NmeAIII	GCCGAGnnnnnnnnnnnnnnnnnnn_nn'
NmeA6CIII	GCCGACnnnnnnnnnnnnnnnnnnn_nn'
NmeDI	rCCGGynnnnnnn'nnnnn_
NmuCI	'GTsAC_
NotI	GC'GGCC_GC
NruI	TCG'CGA
NsbI	TGC'GCA
NsiI	A_TGCA'T
NspI	r_CATG'y
NspV	TT'CG_AA
NspBII	CmG'CkG
OliI	CACnn'nnGTG
PabI	G_TA'C
PacI	TTA_AT'TAA
PaeI	G_CATG'C
PaeR7I	C'TCGA_G
PagI	T'CATG_A
PalAI	GG'CGCG_CC
PasI	CC'CwG_GG
PauI	G'CGCG_C
PceI	AGG'CCT
PciI	A'CATG_T
PciSI	GCTCTTCn'nnn_
PcsI	wCGnnn_n'nnnCGw
PctI	GAATG_Cn'
PdiI	GCC'GGC
PdmI	GAAnn'nnTTC
PfeI	G'AwT_C
Pfl23II	C'GTAC_G
Pfl8569I	GCn'nGC
PflFI	GACn'n_nGTC
PflMI	CCAn_nnn'nTGG
PfoI	T'CCnGG_A
PinAI	A'CCGG_T
PkrI	GC_n'GC
PlaDI	CATCAGnnnnnnnnnnnnnnnnnnn_nn'
PleI	GAGTCnnnn'n_
Ple19I	CG_AT'CG
PluTI	G_GCGC'C
PmaCI	CAC'GTG
PmeI	GTTT'AAAC
PmlI	CAC'GTG
PpiI	GAACnnnnnCTCnnnnnnnn_nnnnn'
PpiI	GAGnnnnnGTTCnnnnnnn_nnnnn'
PpsI	GAGTCnnnn'n_
Ppu10I	A'TGCA_T
Ppu21I	yAC'GTr
PpuMI	rG'GwC_Cy
PscI	A'CATG_T
PshAI	GACnn'nnGTC
PshBI	AT'TA_AT
PsiI	TTA'TAA
Psp03I	G_GwC'C
Psp5II	rG'GwC_Cy
Psp6I	'CCwGG_
Psp1406I	AA'CG_TT
Psp124BI	G_AGCT'C
PspCI	CAC'GTG
PspEI	G'GTnAC_C
PspFI	C'CCAG_C
PspGI	'CCwGG_
PspLI	C'GTAC_G
PspN4I	GGn'nCC
PspOMI	G'GGCC_C
PspOMII	CGCCCArnnnnnnnnnnnnnnnnnn_nn'
PspPI	G'GnC_C
PspPPI	rG'GwC_Cy
PspPRI	CCyCAGnnnnnnnnnnnnn_nn'
PspXI	vC'TCGA_Gb
PsrI	GAACnnnnnnTACnnnnnnn_nnnnn'
PsrI	GTAnnnnnnGTTCnnnnnnn_nnnnn'
PssI	rG_GnC'Cy
PstI	C_TGCA'G
PstNI	CAG_nnn'CTG
PsuI	r'GATC_y
PsyI	GACn'n_nGTC
PteI	G'CGCG_C
PvuI	CG_AT'CG
PvuII	CAG'CTG
RceI	CATCGACnnnnnnnnnnnnnnnnnn_nn'
RdeGBII	ACCCAGnnnnnnnnnnnnnnnnnn_nn'
RdeGBIII	TGryCAnnnnnnnnn_nn'
RgaI	GCG_AT'CGC
RigI	GG_CCGG'CC
RlaII	ACACAGnnnnnnnnnnnnnnnnnn_nn'
RleAI	CCCACAnnnnnnnnn_nnn'
RpaI	GTyGGAGnnnnnnnnn_nn'
RpaBI	CCCGCAGnnnnnnnnnnnnnnnnnn_nn'
RpaB5I	CGrGGACnnnnnnnnnnnnnnnnnn_nn'
RruI	TCG'CGA
RsaI	GT'AC
RsaNI	G'TA_C
RseI	CAynn'nnrTG
RsrII	CG'GwC_CG
Rsr2I	CG'GwC_CG
SacI	G_AGCT'C
SacII	CC_GC'GG
SalI	G'TCGA_C
SanDI	GG'GwC_CC
SapI	GCTCTTCn'nnn_
SaqAI	T'TA_A
SatI	GC'n_GC
SauI	CC'TnA_GG
Sau96I	G'GnC_C
Sau3AI	'GATC_
SbfI	CC_TGCA'GG
ScaI	AGT'ACT
SchI	GAGTCnnnnn'
SciI	CTC'GAG
ScrFI	CC'n_GG
SdaI	CC_TGCA'GG
SdeAI	CAGrAGnnnnnnnnnnnnnnnnnnn_nn'
SdeOSI	GACnnnnrTGAnnnnnnnnnn_nn'
SdeOSI	TCAynnnnGTCnnnnnnnnnnn_nn'
SduI	G_dGCh'C
SecI	C'CnnG_G
SelI	'CGCG_
SetI	_AssT'
SexAI	A'CCwGG_T
SfaAI	GCG_AT'CGC
SfaNI	GCATCnnnnn'nnnn_
SfcI	C'TryA_G
SfeI	C'TryA_G
SfiI	GGCCn_nnn'nGGCC
SfoI	GGC'GCC
Sfr274I	C'TCGA_G
Sfr303I	CC_GC'GG
SfuI	TT'CG_AA
SgeI	CnnGnnnnnnnnn'nnnn_
SgfI	GCG_AT'CGC
SgrAI	Cr'CCGG_yG
SgrBI	CC_GC'GG
SgrDI	CG'TCGA_CG
SgrTI	CCdsnnnnnnnnnn'nnnn_
SgsI	GG'CGCG_CC
SimI	GG'GTC_
SinI	G'GwC_C
SlaI	C'TCGA_G
SmaI	CCC'GGG
SmiI	ATTT'AAAT
SmiMI	CAynn'nnrTG
SmlI	C'TyrA_G
SmoI	C'TyrA_G
SnaBI	TAC'GTA
SpeI	A'CTAG_T
SphI	G_CATG'C
SplI	C'GTAC_G
SrfI	GCCC'GGGC
Sse9I	'AATT_
Sse232I	CG'CCGG_CG
Sse8387I	CC_TGCA'GG
Sse8647I	AG'GwC_CT
SseBI	AGG'CCT
SsiI	C'CG_C
SspI	AAT'ATT
SspDI	G'GCGC_C
SspD5I	GGTGAnnnnnnnn'
SspMI	C'TA_G
SstI	G_AGCT'C
SstE37I	CGAAGACnnnnnnnnnnnnnnnnnn_nn'
Sth132I	CCCGnnnn'nnnn_
Sth302II	CC'GG
StsI	GGATGnnnnnnnnnn'nnnn_
StuI	AGG'CCT
StyI	C'CwwG_G
StyD4I	'CCnGG_
SwaI	ATTT'AAAT
TaaI	AC_n'GT
TaiI	_ACGT'
TaqI	T'CG_A
TaqII	GACCGAnnnnnnnnn_nn'
TaqIII	CACCCAnnnnnnnnn_nn'
TasI	'AATT_
TatI	w'GTAC_w
TauI	G_CsG'C
TfiI	G'AwT_C
Tru1I	T'TA_A
Tru9I	T'TA_A
TscAI	_nnCAsTGnn'
TseI	G'CwG_C
TseFI	'GTsAC_
TsoI	TArCCAnnnnnnnnn_nn'
Tsp45I	'GTsAC_
Tsp4CI	AC_n'GT
TspDTI	ATGAAnnnnnnnnn_nn'
TspEI	'AATT_
TspGWI	ACGGAnnnnnnnnn_nn'
TspMI	C'CCGG_G
TspRI	_nnCAsTGnn'
TstI	CACnnnnnnTCCnnnnnnn_nnnnn'
TstI	GGAnnnnnnGTGnnnnnnnn_nnnnn'
Tth111I	GACn'n_nGTC
Tth111II	CAArCAnnnnnnnnn_nn'
UcoMSI	GAGCTCnnnnn'nn_
UnbI	'GGnCC_
Van91I	CCAn_nnn'nTGG
Vha464I	C'TTAA_G
VneI	G'TGCA_C
VpaK11AI	'GGwCC_
VpaK11BI	G'GwC_C
VspI	AT'TA_AT
WviI	CACrAGnnnnnnnnnnnnnnnnnnn_nn'
XagI	CCTnn'n_nnAGG
XapI	r'AATT_y
XbaI	T'CTAG_A
XceI	r_CATG'y
XcmI	CCAnnnn_n'nnnnTGG
XhoI	C'TCGA_G
XhoII	r'GATC_y
XmaI	C'CCGG_G
XmaIII	C'GGCC_G
XmaJI	C'CTAG_G
XmiI	GT'mk_AC
XmnI	GAAnn'nnTTC
XspI	C'TA_G
YkrI	Cnnnnnnnnn_n'
ZraI	GAC'GTC
ZrmI	AGT'ACT
Zsp2I	A_TGCA'T`;
